m00_10_00_00
m00_12_00_00
m00_90_00_00
m01_00_30_00
m01_00_50_00
m01_00_60_00
m01_00_70_00
m01_00_80_00
m01_01_00_00
m01_01_10_00
m01_01_30_00
m01_01_40_00
m01_01_50_00
m01_01_60_00
m01_01_80_00
m01_02_30_00
m01_02_50_00
m01_02_60_00
m01_02_80_00
m01_03_20_00
m01_03_50_00
m01_03_60_00
m01_03_70_00
m01_03_90_00
m01_04_00_00
m01_04_10_00
m01_04_20_00
m01_04_60_00
m01_04_70_00
m01_04_80_00
m01_04_90_00
m01_05_30_00
m01_06_00_00
m01_06_10_00
m01_06_20_00
m01_06_30_00
m01_06_40_00
m01_06_60_00
m01_06_80_00
m01_06_90_00
m01_07_20_00
m01_07_50_00
m01_07_60_00
m01_07_70_00
m01_07_80_00
m01_08_10_00
m01_08_40_00
m01_08_50_00
m01_08_60_00
m01_08_70_00
m01_08_80_00
m01_08_90_00
m01_09_00_00
m01_09_10_00
m01_10_00_00
m01_10_20_00
m01_10_40_00
m01_10_60_00
m01_10_70_00
m01_10_90_00
m01_11_00_00
m01_11_30_00
m01_11_40_00
m01_11_60_00
m01_11_70_00
m01_12_00_00
m01_12_10_00
m01_12_20_00
m01_12_30_00
m01_40_00_00
m01_40_10_00
m01_40_20_00
m01_40_30_00
m01_40_40_00
m01_40_50_00
m01_40_60_00
m01_40_70_00
m01_40_90_00
m01_41_00_00
m01_50_10_00
m01_50_20_00
m01_50_30_00
m01_50_40_00
m01_50_50_00
m01_50_60_00
m01_50_70_00
m01_50_80_00
m01_50_90_00
m01_51_00_00
m01_51_10_00
m01_51_20_00
m01_51_30_00
m01_51_40_00
m01_51_50_00
m01_51_60_00
m01_51_70_00
m03_20_00_00
m03_30_00_00
m03_40_00_00
m03_60_00_00
m10_00_00_00
m10_01_00_00
m10_10_00_00
m10_20_00_00
m20_00_00_00
m20_20_00_00
m20_30_00_00
m30_00_00_00
m41_00_00_00
m41_10_00_00
m50_00_00_00
m50_10_00_00
m50_30_00_00
m50_40_00_00
m50_50_00_00
m50_60_00_00